#   ##           
# # ## ###### ###
# #    #      #G#
# # ## ######## #
# # ##          #
# # ########### #
# # ##          #
# #### ######## #
###### #        #
S      ##########