#   ##          G
# # ## ###### ###
# #    #      # #
# # ## ######## #
# # ##          #
# # #############
# #             #
# #### ######## #
###### #     G  #
S      ##########
